111111
1E10P1
111001
100001
1C1001
111111
