1111111111111111111111111111
1E0000000000000C00000C000001
1010010100100000101001000001
1010010C1010101000100100C001
1010010100100000101001000001
1010010010101010001001000001
1010010100100000101001000C01
1010010010101010001001000001
100C00000C00C000000000C00001
1010010100100000101001000001
1010010010101010001001000001
100C00000C00C000000000C00001
1P0C00000C00C000000000C00001
1111111111111111111111111111
